Date,BURGLARY_Austin,BURGLARY_Chicago,BURGLARY_LA,BURGLARY_Cities,THEFT_Austin,THEFT_Chicago,THEFT_LA,THEFT_Cities,AGGRASSAULT_Austin,AGGRASSAULT_Chicago,AGGRASSAULT_LA,AGGRASSAULT_Cities, RAPE_Austin,RAPE_Chicago,RAPE_LA,RAPE_Cities,MURDER_Austin,MURDER_Chicago,MURDER_LA,MURDER_Cities,MISC_Austin,MISC_Chicago,,,DRUG_Austin,DRUG_Chicago,,,FRAUD_Austin,FRAUD_Chicago
1/1/2016,18,33,95,146,55,62,95,212,13,195,212,420,5,17,64,86,0,3,0,3,22,162,,,1,21,,,2,50
1/2/2016,11,47,79,137,56,80,84,220,9,114,106,229,2,8,5,15,0,0,1,1,0,132,,,0,27,,,0,27
1/3/2016,18,62,74,154,56,75,55,186,8,139,123,270,2,4,8,14,0,1,0,1,0,147,,,0,29,,,0,21
1/4/2016,15,70,78,163,118,73,75,266,3,117,98,218,3,6,6,15,0,1,2,3,0,148,,,0,23,,,0,29
1/5/2016,18,59,86,163,84,91,69,244,8,131,107,246,0,4,10,14,0,5,1,6,0,116,,,0,38,,,0,31
1/6/2016,16,61,91,168,68,88,66,222,8,128,80,216,3,6,5,14,0,1,2,3,2,147,,,0,33,,,0,32
1/7/2016,19,63,95,177,95,86,73,254,3,125,101,229,4,7,4,15,0,2,0,2,0,158,,,0,39,,,0,37
1/8/2016,27,79,80,186,75,92,100,267,4,132,83,219,1,4,6,11,0,2,3,5,0,174,,,0,48,,,0,28
1/9/2016,14,61,88,163,60,76,80,216,5,145,100,250,3,8,14,25,0,2,0,2,0,147,,,0,35,,,0,25
1/10/2016,17,65,78,160,68,76,65,209,7,126,104,237,1,5,11,17,0,0,0,0,1,148,,,0,28,,,0,27
1/11/2016,28,64,79,171,77,76,69,222,5,111,132,248,0,2,5,7,0,1,1,2,2,114,,,0,16,,,0,28
1/12/2016,21,50,88,159,75,70,70,215,4,104,97,205,0,7,5,12,0,0,0,0,0,138,,,0,32,,,0,29
1/13/2016,18,65,86,169,71,76,83,230,5,109,99,213,3,5,3,11,0,3,0,3,0,160,,,0,34,,,0,40
1/14/2016,19,70,99,188,66,79,79,224,4,141,89,234,1,12,9,22,0,1,0,1,0,164,,,0,44,,,0,30
1/15/2016,23,69,121,213,77,91,97,265,6,142,118,266,3,3,5,11,0,1,0,1,0,169,,,0,37,,,0,33
1/16/2016,14,56,95,165,73,85,90,248,6,132,133,271,2,6,8,16,0,3,0,3,0,159,,,0,38,,,0,31
1/17/2016,16,46,74,136,65,68,81,214,6,133,144,283,1,4,8,13,0,1,4,5,1,128,,,0,26,,,0,30
1/18/2016,24,43,74,141,103,61,91,255,3,101,117,221,2,2,3,7,0,0,2,2,1,142,,,0,33,,,0,29
1/19/2016,22,57,79,158,103,80,80,263,4,110,83,197,2,1,9,12,0,1,1,2,2,149,,,0,31,,,0,35
1/20/2016,23,58,94,175,88,81,82,251,7,121,116,244,1,5,11,17,0,1,1,2,2,129,,,0,34,,,0,28
1/21/2016,24,68,106,198,89,91,81,261,1,117,127,245,1,3,10,14,0,3,0,3,1,147,,,0,32,,,0,27
1/22/2016,16,64,89,169,95,95,93,283,8,120,118,246,4,4,10,18,1,0,0,1,0,161,,,1,53,,,0,30
1/23/2016,12,64,100,176,69,100,92,261,4,137,126,267,4,4,7,15,0,2,2,4,4,152,,,0,40,,,0,36
1/24/2016,23,64,87,174,64,82,96,242,5,144,123,272,3,3,7,13,0,3,0,3,0,190,,,0,24,,,0,19
1/25/2016,22,74,90,186,99,99,98,296,6,151,104,261,4,3,9,16,0,5,2,7,1,165,,,0,32,,,0,35
1/26/2016,22,63,93,178,85,72,85,242,4,122,99,225,1,4,6,11,0,4,0,4,1,157,,,0,40,,,0,34
1/27/2016,21,59,77,157,69,85,78,232,7,135,107,249,1,0,5,6,0,1,0,1,0,164,,,1,32,,,0,43
1/28/2016,28,63,88,179,77,89,72,238,4,119,97,220,3,4,5,12,0,1,1,2,0,168,,,0,95,,,0,30
1/29/2016,21,87,111,219,94,91,91,276,4,129,132,265,2,3,8,13,0,2,2,4,1,153,,,0,43,,,0,32
1/30/2016,10,39,95,144,67,94,76,237,6,162,124,292,0,5,1,6,0,3,0,3,0,180,,,0,36,,,0,36
1/31/2016,11,55,69,135,91,85,62,238,7,164,114,285,4,5,6,15,0,1,1,2,1,162,,,0,23,,,0,25
2/1/2016,19,80,102,201,97,94,126,317,11,141,119,271,2,10,29,41,0,2,0,2,2,168,,,0,44,,,1,43
2/2/2016,21,49,73,143,82,71,108,261,1,118,94,213,2,10,7,19,0,2,0,2,0,136,,,0,37,,,0,37
2/3/2016,19,56,93,168,86,84,97,267,1,130,100,231,4,3,7,14,0,2,0,2,0,167,,,1,41,,,0,35
2/4/2016,15,49,86,150,76,77,75,228,2,140,89,231,1,5,7,13,0,4,0,4,1,161,,,0,53,,,0,31
2/5/2016,14,54,89,157,59,89,88,236,9,124,137,270,3,7,10,20,0,0,1,1,1,153,,,0,46,,,0,29
2/6/2016,12,53,79,144,65,83,88,236,8,149,126,283,1,8,7,16,0,1,2,3,1,156,,,0,40,,,0,51
2/7/2016,14,35,88,137,84,88,74,246,9,134,170,313,1,6,6,13,0,1,1,2,0,172,,,0,27,,,0,18
2/8/2016,22,45,76,143,85,81,84,250,4,116,124,244,1,7,16,24,0,1,2,3,1,146,,,0,29,,,0,26
2/9/2016,19,33,85,137,68,81,80,229,3,122,126,251,3,4,5,12,0,0,1,1,0,119,,,0,34,,,0,29
2/10/2016,24,36,78,138,80,69,73,222,5,119,134,258,1,3,5,9,0,3,0,3,0,149,,,0,41,,,0,37
2/11/2016,17,46,77,140,79,88,82,249,5,122,99,226,2,4,7,13,0,1,0,1,1,142,,,0,41,,,0,28
2/12/2016,9,42,93,144,80,95,71,246,13,109,122,244,2,8,11,21,0,0,0,0,0,142,,,0,68,,,0,37
2/13/2016,12,38,87,137,47,72,70,189,7,125,138,270,1,3,5,9,0,3,1,4,0,139,,,0,47,,,0,27
2/14/2016,18,44,48,110,65,63,70,198,5,132,161,298,1,6,5,12,0,3,1,4,0,131,,,0,28,,,0,18
2/15/2016,25,44,62,131,93,71,75,239,4,124,133,261,0,4,8,12,0,0,0,0,0,122,,,0,50,,,0,30
2/16/2016,22,46,75,143,90,81,80,251,5,129,115,249,4,6,9,19,0,3,0,3,0,131,,,0,34,,,0,31
2/17/2016,17,48,80,145,68,79,92,239,7,154,112,273,2,4,4,10,0,1,0,1,1,140,,,0,48,,,0,38
2/18/2016,22,57,78,157,72,95,78,245,8,131,118,257,2,3,4,9,0,1,1,2,0,150,,,0,42,,,0,28
2/19/2016,14,54,96,164,81,101,89,271,6,136,136,278,3,4,8,15,0,0,0,0,0,203,,,0,56,,,0,34
2/20/2016,9,46,83,138,61,73,86,220,3,174,138,315,2,6,8,16,0,3,2,5,1,158,,,0,43,,,0,35
2/21/2016,15,45,66,126,69,76,79,224,9,172,170,351,0,9,8,17,0,2,2,4,0,159,,,0,48,,,0,24
2/22/2016,22,48,80,150,82,71,76,229,7,142,119,268,7,3,9,19,0,3,1,4,1,142,,,0,42,,,0,31
2/23/2016,14,45,90,149,65,92,77,234,5,134,111,250,2,8,4,14,0,0,3,3,1,149,,,0,32,,,0,35
2/24/2016,18,46,80,144,70,75,83,228,6,124,119,249,2,5,6,13,0,3,1,4,0,144,,,0,33,,,0,26
2/25/2016,19,33,83,135,71,83,86,240,7,137,103,247,5,2,7,14,0,0,0,0,1,168,,,0,89,,,0,34
2/26/2016,20,52,93,165,77,89,81,247,2,159,144,305,4,6,7,17,0,1,1,2,0,157,,,0,40,,,0,40
2/27/2016,11,35,76,122,60,84,73,217,3,144,180,327,1,7,15,23,0,1,1,2,0,165,,,0,36,,,0,36
2/28/2016,7,41,45,93,55,74,77,206,8,157,179,344,1,7,8,16,0,0,0,0,0,158,,,0,33,,,0,23
2/29/2016,16,39,76,131,78,89,69,236,8,137,102,247,7,8,10,25,0,0,1,1,1,161,,,0,30,,,0,25
3/1/2016,12,45,89,146,94,79,114,287,9,121,125,255,1,12,20,33,1,2,0,3,8,170,,,0,51,,,0,49
3/2/2016,30,48,95,173,71,85,89,245,7,122,108,237,0,3,4,7,0,3,0,3,0,146,,,0,56,,,0,26
3/3/2016,15,51,93,159,79,72,63,214,4,118,87,209,3,4,5,12,0,0,1,1,1,139,,,0,55,,,0,34
3/4/2016,13,51,88,152,103,79,78,260,4,138,106,248,2,5,9,16,1,2,0,3,0,169,,,0,66,,,0,28
3/5/2016,11,50,78,139,53,93,72,218,6,151,122,279,2,7,14,23,0,0,1,1,2,165,,,0,34,,,0,26
3/6/2016,21,40,71,132,68,81,77,226,10,151,138,299,2,6,7,15,0,0,0,0,0,182,,,0,52,,,0,34
3/7/2016,8,60,66,134,95,83,72,250,10,161,93,264,4,7,7,18,0,1,0,1,1,169,,,0,60,,,0,35
3/8/2016,16,56,85,157,77,90,86,253,12,160,108,280,1,5,7,13,0,1,0,1,0,176,,,0,27,,,0,25
3/9/2016,14,43,75,132,93,76,87,256,1,181,108,290,1,4,8,13,0,3,1,4,0,148,,,0,49,,,0,35
3/10/2016,13,48,74,135,64,89,100,253,8,140,97,245,2,5,11,18,0,2,1,3,0,163,,,0,58,,,1,23
3/11/2016,27,47,96,170,77,96,71,244,1,149,95,245,2,9,8,19,0,3,0,3,0,167,,,0,58,,,0,34
3/12/2016,13,45,72,130,61,88,84,233,8,184,142,334,1,7,10,18,0,1,0,1,0,174,,,0,27,,,0,28
3/13/2016,14,41,65,120,73,81,74,228,12,157,177,346,1,7,8,16,0,1,2,3,0,138,,,0,32,,,0,30
3/14/2016,21,60,75,156,86,90,77,253,7,140,129,276,2,5,6,13,0,1,2,3,0,160,,,0,36,,,0,40
3/15/2016,16,58,89,163,91,88,88,267,7,151,119,277,2,7,8,17,0,4,0,4,0,163,,,0,42,,,0,28
3/16/2016,9,54,98,161,80,86,74,240,10,174,131,315,1,5,4,10,1,1,0,2,1,166,,,0,47,,,0,34
3/17/2016,21,48,87,156,75,96,66,237,3,154,139,296,2,8,10,20,0,1,0,1,0,177,,,0,40,,,0,26
3/18/2016,19,59,80,158,92,93,92,277,11,163,115,289,0,6,6,12,0,3,1,4,0,186,,,0,58,,,0,37
3/19/2016,15,47,77,139,81,83,68,232,7,145,130,282,1,6,4,11,0,0,2,2,0,171,,,0,42,,,0,36
3/20/2016,17,42,76,135,75,77,81,233,11,170,129,310,3,6,6,15,0,2,1,3,0,165,,,0,35,,,0,28
3/21/2016,25,59,57,141,79,74,89,242,6,154,115,275,3,3,6,12,0,1,1,2,0,171,,,0,40,,,0,33
3/22/2016,14,48,81,143,118,90,76,284,3,175,110,288,2,7,2,11,0,2,1,3,0,164,,,0,41,,,0,32
3/23/2016,22,61,79,162,94,98,84,276,4,147,107,258,0,5,5,10,0,3,1,4,0,150,,,0,34,,,0,27
3/24/2016,22,56,106,184,96,79,78,253,6,146,131,283,3,4,9,16,0,0,2,2,1,161,,,0,40,,,0,31
3/25/2016,15,46,115,176,61,101,100,262,2,147,114,263,0,7,8,15,0,0,2,2,0,185,,,0,41,,,0,27
3/26/2016,11,49,84,144,59,86,65,210,5,170,137,312,0,3,13,16,0,1,1,2,0,168,,,0,43,,,0,40
3/27/2016,9,48,73,130,45,74,47,166,11,158,146,315,2,7,8,17,0,0,1,1,0,148,,,0,31,,,0,15
3/28/2016,11,66,77,154,92,88,82,262,7,162,114,283,3,5,6,14,0,0,0,0,0,151,,,0,51,,,0,33
3/29/2016,18,60,93,171,94,90,85,269,3,164,103,270,2,8,7,17,0,1,3,4,1,169,,,0,61,,,0,33
3/30/2016,23,54,71,148,75,88,97,260,5,166,133,304,3,3,5,11,0,3,0,3,0,138,,,0,50,,,0,26
3/31/2016,15,59,59,133,66,98,92,256,3,191,109,303,2,8,6,16,0,3,0,3,1,146,,,0,42,,,0,38
4/1/2016,11,53,112,176,88,87,94,269,4,144,143,291,7,12,18,37,0,1,0,1,4,167,,,0,41,,,0,35
4/2/2016,11,47,53,111,80,91,79,250,8,131,152,291,1,6,9,16,0,0,1,1,0,155,,,0,42,,,0,38
4/3/2016,22,37,79,138,60,87,70,217,18,180,158,356,4,4,7,15,0,1,1,2,0,152,,,0,40,,,0,32
4/4/2016,26,48,83,157,103,83,92,278,8,128,106,242,2,5,16,23,0,1,0,1,1,158,,,0,37,,,1,33
4/5/2016,19,49,71,139,87,81,84,252,4,120,137,261,3,3,11,17,0,1,2,3,1,156,,,0,55,,,0,32
4/6/2016,12,38,84,134,94,92,76,262,11,141,130,282,0,5,10,15,0,3,0,3,0,150,,,0,56,,,0,23
4/7/2016,24,49,93,166,76,88,96,260,3,149,117,269,2,2,9,13,0,2,1,3,1,174,,,0,87,,,1,38
4/8/2016,11,41,111,163,75,89,77,241,4,116,124,244,3,5,10,18,1,2,1,4,0,170,,,0,37,,,0,33
4/9/2016,13,32,73,118,76,97,69,242,9,136,123,268,3,11,7,21,0,2,2,4,1,172,,,0,44,,,0,42
4/10/2016,17,45,62,124,75,82,73,230,9,155,170,334,4,8,13,25,0,2,1,3,1,175,,,0,38,,,0,35
4/11/2016,22,60,77,159,124,95,85,304,7,139,137,283,2,5,8,15,0,2,0,2,0,158,,,0,33,,,0,37
4/12/2016,21,54,81,156,87,98,89,274,5,142,132,279,1,4,14,19,0,0,2,2,2,154,,,0,55,,,0,41
4/13/2016,16,53,80,149,85,78,77,240,4,166,111,281,1,3,11,15,0,1,3,4,0,167,,,0,46,,,0,40
4/14/2016,18,48,109,175,82,92,80,254,7,138,111,256,3,5,6,14,0,0,1,1,2,157,,,0,49,,,0,32
4/15/2016,17,47,104,168,92,115,119,326,6,147,160,313,1,5,8,14,0,3,0,3,0,178,,,0,71,,,1,38
4/16/2016,19,53,86,158,66,83,94,243,9,184,170,363,4,3,11,18,0,1,0,1,0,170,,,0,37,,,0,20
4/17/2016,10,47,71,128,66,82,78,226,11,175,174,360,5,5,11,21,0,1,0,1,0,178,,,0,36,,,0,25
4/18/2016,21,53,89,163,78,98,91,267,6,154,130,290,2,5,5,12,0,0,0,0,0,184,,,0,32,,,0,35
4/19/2016,16,41,88,145,95,111,83,289,3,157,129,289,1,2,9,12,0,2,1,3,0,150,,,0,44,,,0,32
4/20/2016,17,52,87,156,83,87,97,267,4,133,136,273,1,4,10,15,0,1,3,4,0,176,,,0,48,,,0,36
4/21/2016,16,45,90,151,95,92,76,263,6,160,108,274,4,6,7,17,0,0,0,0,0,187,,,0,46,,,0,30
4/22/2016,10,56,97,163,77,100,103,280,4,142,128,274,1,3,3,7,0,2,0,2,0,182,,,0,54,,,0,28
4/23/2016,15,44,79,138,70,80,84,234,4,165,146,315,3,9,12,24,0,2,1,3,1,168,,,0,32,,,0,29
4/24/2016,24,45,82,151,73,87,74,234,9,184,145,338,1,8,8,17,0,3,0,3,0,171,,,0,56,,,0,20
4/25/2016,24,54,98,176,92,85,92,269,9,177,122,308,4,10,10,24,0,2,0,2,1,161,,,0,41,,,0,24
4/26/2016,18,60,81,159,88,86,99,273,11,140,120,271,5,5,7,17,0,2,0,2,0,167,,,0,48,,,1,30
4/27/2016,23,67,87,177,82,83,69,234,8,150,123,281,4,5,8,17,0,0,1,1,1,152,,,0,43,,,0,25
4/28/2016,22,59,99,180,81,93,92,266,2,148,93,243,1,8,3,12,0,0,0,0,0,167,,,0,45,,,0,33
4/29/2016,22,54,91,167,75,86,80,241,7,161,112,280,2,7,10,19,0,0,1,1,1,146,,,0,54,,,0,28
4/30/2016,16,45,80,141,48,88,102,238,10,139,147,296,0,5,8,13,0,2,0,2,0,127,,,0,34,,,0,29
5/1/2016,13,59,85,157,53,80,116,249,8,158,168,334,1,13,43,57,0,0,0,0,7,160,,,0,26,,,0,37
5/2/2016,32,59,86,177,78,90,96,264,4,149,133,286,0,4,3,7,0,5,1,6,0,156,,,0,44,,,1,33
5/3/2016,20,62,87,169,94,72,101,267,2,151,122,275,3,9,7,19,0,2,1,3,0,176,,,0,45,,,0,32
5/4/2016,20,54,68,142,71,75,80,226,5,146,113,264,1,7,4,12,0,3,1,4,0,177,,,0,49,,,0,27
5/5/2016,17,53,77,147,76,98,77,251,6,142,146,294,4,6,8,18,0,0,1,1,0,158,,,0,50,,,0,29
5/6/2016,23,57,93,173,78,95,85,258,1,169,110,280,1,8,7,16,0,2,0,2,0,174,,,0,40,,,0,37
5/7/2016,17,57,84,158,62,87,83,232,5,176,124,305,3,10,6,19,0,4,0,4,0,157,,,0,14,,,0,44
5/8/2016,14,49,84,147,78,78,72,228,7,189,146,342,0,6,7,13,1,4,0,5,0,178,,,0,32,,,0,28
5/9/2016,22,60,83,165,90,84,72,246,3,166,106,275,0,5,6,11,0,3,0,3,0,167,,,0,42,,,0,35
5/10/2016,17,57,91,165,85,85,91,261,6,154,95,255,0,3,8,11,0,2,0,2,1,165,,,0,40,,,0,35
5/11/2016,25,59,94,178,70,97,82,249,8,167,113,288,3,6,8,17,0,3,0,3,0,165,,,0,40,,,0,39
5/12/2016,25,55,90,170,88,87,91,266,3,150,109,262,3,2,9,14,0,2,0,2,0,152,,,0,49,,,0,32
5/13/2016,16,57,94,167,93,99,89,281,4,160,128,292,1,6,8,15,0,1,0,1,1,197,,,0,46,,,0,39
5/14/2016,9,53,84,146,50,93,87,230,7,157,135,299,2,5,8,15,1,4,1,6,0,172,,,0,45,,,0,24
5/15/2016,8,55,67,130,51,88,84,223,7,173,164,344,2,6,7,15,0,4,1,5,0,178,,,0,37,,,0,22
5/16/2016,14,65,89,168,110,100,92,302,5,163,108,276,3,9,7,19,0,4,1,5,2,177,,,0,51,,,0,34
5/17/2016,17,59,82,158,79,93,96,268,6,143,115,264,1,7,4,12,0,1,0,1,3,183,,,0,44,,,0,26
5/18/2016,22,70,86,178,105,98,82,285,9,164,126,299,2,3,3,8,0,2,0,2,1,184,,,0,44,,,1,28
5/19/2016,20,59,79,158,52,103,98,253,4,146,125,275,2,5,5,12,0,1,0,1,0,177,,,0,79,,,0,22
5/20/2016,12,59,92,163,82,89,92,263,4,163,147,314,3,6,11,20,1,3,1,5,0,177,,,0,52,,,0,30
5/21/2016,12,62,68,142,57,99,90,246,8,163,141,312,0,7,15,22,0,3,0,3,1,182,,,0,36,,,0,35
5/22/2016,17,55,90,162,58,98,71,227,16,185,146,347,3,7,3,13,0,1,2,3,0,159,,,0,48,,,0,18
5/23/2016,20,63,74,157,88,88,102,278,7,176,122,305,2,8,4,14,0,0,0,0,0,177,,,0,42,,,0,31
5/24/2016,11,58,88,157,64,104,95,263,3,173,116,292,2,3,7,12,0,1,1,2,1,184,,,0,43,,,0,33
5/25/2016,10,51,91,152,77,87,90,254,7,172,106,285,4,14,5,23,0,0,0,0,1,156,,,0,34,,,0,30
5/26/2016,19,50,90,159,87,94,86,267,9,173,121,303,0,8,9,17,0,2,1,3,1,170,,,0,41,,,0,26
5/27/2016,15,58,124,197,88,99,102,289,4,160,132,296,2,13,11,26,0,4,0,4,0,193,,,0,48,,,0,27
5/28/2016,25,49,82,156,78,101,80,259,8,177,116,301,2,10,10,22,0,3,1,4,0,181,,,0,48,,,0,25
5/29/2016,19,60,86,165,74,80,83,237,12,207,167,386,2,6,9,17,0,0,0,0,1,188,,,0,45,,,0,20
5/30/2016,20,60,77,157,64,105,65,234,8,203,155,366,2,6,13,21,0,2,0,2,0,180,,,0,42,,,0,24
5/31/2016,18,65,77,160,75,92,99,266,2,168,119,289,3,6,7,16,0,1,1,2,0,179,,,0,48,,,1,38
6/1/2016,14,54,90,158,87,98,124,309,8,172,142,322,5,19,33,57,0,4,3,7,13,195,,,0,45,,,3,41
6/2/2016,11,50,72,133,89,104,109,302,10,178,111,299,3,9,5,17,0,1,3,4,0,187,,,0,41,,,0,35
6/3/2016,16,54,94,164,89,84,100,273,8,181,138,327,2,9,6,17,0,2,0,2,0,182,,,0,56,,,0,36
6/4/2016,6,46,66,118,60,95,95,250,6,194,153,353,7,8,7,22,0,5,0,5,2,170,,,0,40,,,0,65
6/5/2016,17,54,74,145,63,90,62,215,9,183,128,320,2,6,5,13,1,3,0,4,0,151,,,0,41,,,0,44
6/6/2016,18,52,79,149,94,96,84,274,9,167,119,295,0,7,10,17,0,2,1,3,0,168,,,0,42,,,0,37
6/7/2016,16,61,67,144,83,87,85,255,5,174,118,297,3,3,7,13,0,0,1,1,1,167,,,0,47,,,0,48
6/8/2016,14,64,94,172,74,91,82,247,2,154,119,275,0,3,16,19,0,2,0,2,0,175,,,0,49,,,0,33
6/9/2016,14,42,109,165,97,86,95,278,4,149,109,262,1,11,9,21,0,1,0,1,1,170,,,0,37,,,0,45
6/10/2016,19,52,99,170,99,100,98,297,11,157,126,294,1,5,7,13,0,2,0,2,1,171,,,0,40,,,0,36
6/11/2016,15,40,104,159,70,108,74,252,7,187,124,318,2,5,5,12,0,4,3,7,0,177,,,0,37,,,0,41
6/12/2016,20,52,75,147,66,100,76,242,16,190,172,378,0,11,7,18,0,3,0,3,0,188,,,1,51,,,0,23
6/13/2016,25,51,86,162,87,100,83,270,10,176,110,296,3,7,8,18,0,1,5,6,0,178,,,0,33,,,0,41
6/14/2016,16,60,75,151,98,101,81,280,4,175,107,286,1,2,6,9,1,4,0,5,1,197,,,0,47,,,0,40
6/15/2016,12,68,87,167,76,94,97,267,7,165,112,284,3,5,5,13,0,1,0,1,0,181,,,0,47,,,0,39
6/16/2016,19,61,77,157,82,102,97,281,5,163,133,301,5,8,1,14,1,7,1,9,0,195,,,0,36,,,0,27
6/17/2016,22,56,100,178,55,108,100,263,11,178,123,312,3,12,3,18,0,2,1,3,0,192,,,0,38,,,0,40
6/18/2016,20,54,75,149,61,99,91,251,7,163,148,318,2,13,5,20,0,7,2,9,1,157,,,0,34,,,0,20
6/19/2016,13,63,71,147,48,100,75,223,7,205,171,383,3,7,6,16,0,3,0,3,0,161,,,1,22,,,0,22
6/20/2016,17,63,86,166,114,93,80,287,8,203,146,357,2,11,12,25,0,2,0,2,1,181,,,0,36,,,0,29
6/21/2016,22,51,88,161,110,105,89,304,5,173,132,310,3,9,2,14,0,1,0,1,0,182,,,0,33,,,1,35
6/22/2016,17,63,95,175,88,101,96,285,6,176,125,307,2,6,3,11,0,1,2,3,1,171,,,0,37,,,0,37
6/23/2016,24,69,82,175,90,108,85,283,5,171,128,304,4,11,5,20,0,2,2,4,1,166,,,0,44,,,0,35
6/24/2016,21,64,73,158,86,117,77,280,8,161,154,323,0,6,12,18,0,4,0,4,0,172,,,0,48,,,0,31
6/25/2016,16,59,100,175,59,101,92,252,7,187,143,337,3,5,6,14,1,1,0,2,0,192,,,0,30,,,0,27
6/26/2016,8,58,93,159,69,87,83,239,8,189,162,359,4,14,8,26,0,4,1,5,1,181,,,0,24,,,0,19
6/27/2016,17,61,89,167,98,92,97,287,8,172,162,342,1,9,8,18,1,2,0,3,1,166,,,0,41,,,0,31
6/28/2016,13,55,98,166,90,98,87,275,1,148,134,283,2,7,7,16,0,2,0,2,2,182,,,0,45,,,0,33
6/29/2016,11,61,65,137,91,96,73,260,5,170,141,316,4,4,5,13,0,3,2,5,0,178,,,0,42,,,0,39
6/30/2016,17,56,96,169,78,99,101,278,3,162,97,262,2,6,9,17,0,2,1,3,2,190,,,0,73,,,1,28
7/1/2016,18,69,102,189,78,95,130,303,5,155,131,291,4,12,27,43,1,2,0,3,8,211,,,0,60,,,0,46
7/2/2016,16,69,71,156,44,89,100,233,7,175,149,331,2,7,7,16,0,2,0,2,1,177,,,0,51,,,0,25
7/3/2016,15,57,88,160,71,88,68,227,5,177,142,324,3,7,8,18,0,1,0,1,0,184,,,0,51,,,0,22
7/4/2016,16,67,88,171,76,83,77,236,7,203,176,386,1,9,14,24,0,1,1,2,0,203,,,0,37,,,0,15
7/5/2016,13,65,75,153,90,86,94,270,6,217,153,376,4,9,5,18,0,5,1,6,0,193,,,0,48,,,2,34
7/6/2016,23,60,90,173,87,92,78,257,7,160,144,311,3,6,5,14,0,2,0,2,0,179,,,0,31,,,0,32
7/7/2016,16,60,89,165,75,113,73,261,5,146,106,257,1,7,4,12,0,0,0,0,1,170,,,0,44,,,0,35
7/8/2016,16,68,103,187,101,114,92,307,6,158,123,287,2,9,9,20,0,1,1,2,0,170,,,0,33,,,0,30
7/9/2016,14,59,76,149,57,99,70,226,6,175,123,304,3,3,11,17,0,1,0,1,0,149,,,0,28,,,0,28
7/10/2016,7,68,82,157,63,89,72,224,3,170,170,343,2,9,10,21,0,2,1,3,0,174,,,0,21,,,0,33
7/11/2016,20,62,91,173,83,88,79,250,10,156,96,262,2,6,6,14,0,2,1,3,0,176,,,0,30,,,0,29
7/12/2016,19,55,84,158,80,94,82,256,5,153,88,246,1,8,7,16,0,2,2,4,2,178,,,0,36,,,0,43
7/13/2016,8,70,105,183,78,84,82,244,6,136,100,242,2,11,4,17,0,2,0,2,1,147,,,0,43,,,1,38
7/14/2016,23,59,91,173,85,101,85,271,6,127,107,240,1,10,4,15,0,3,0,3,1,187,,,0,45,,,0,32
7/15/2016,11,66,79,156,67,112,110,289,4,157,121,282,1,7,3,11,0,1,1,2,6,173,,,0,44,,,0,35
7/16/2016,16,57,83,156,55,86,96,237,3,167,138,308,0,5,6,11,1,1,0,2,1,182,,,0,27,,,0,26
7/17/2016,11,75,86,172,73,66,80,219,7,180,136,323,2,10,11,23,0,4,1,5,1,220,,,0,30,,,0,26
7/18/2016,14,70,81,165,105,96,92,293,6,148,139,293,1,7,3,11,2,2,0,4,1,188,,,0,37,,,0,33
7/19/2016,17,76,99,192,70,101,96,267,4,142,103,249,2,5,2,9,0,2,2,4,1,184,,,0,42,,,0,34
7/20/2016,18,75,113,206,75,97,87,259,3,180,139,322,2,9,5,16,1,1,0,2,1,154,,,0,38,,,0,41
7/21/2016,20,78,90,188,67,106,83,256,3,157,119,279,2,3,7,12,1,4,1,6,0,152,,,0,39,,,0,42
7/22/2016,9,60,94,163,93,92,100,285,9,163,145,317,2,6,8,16,0,2,1,3,0,174,,,0,47,,,1,35
7/23/2016,8,78,99,185,69,101,82,252,6,180,148,334,5,11,10,26,0,2,1,3,1,162,,,0,30,,,0,32
7/24/2016,16,64,66,146,71,89,65,225,7,185,161,353,1,11,5,17,0,4,3,7,2,163,,,0,34,,,0,21
7/25/2016,14,64,87,165,77,107,79,263,9,169,127,305,4,8,6,18,0,2,2,4,1,177,,,0,42,,,0,29
7/26/2016,13,62,75,150,92,119,90,301,5,174,124,303,1,8,7,16,0,1,0,1,1,191,,,0,43,,,0,45
7/27/2016,17,66,88,171,60,109,82,251,8,147,102,257,3,10,5,18,0,2,1,3,1,167,,,0,38,,,0,34
7/28/2016,18,68,73,159,80,87,95,262,5,154,134,293,1,13,9,23,0,4,1,5,0,170,,,0,46,,,1,45
7/29/2016,16,75,88,179,79,100,111,290,4,146,143,293,4,9,4,17,0,5,2,7,1,172,,,0,36,,,0,37
7/30/2016,7,78,91,176,62,109,91,262,5,188,140,333,3,8,8,19,0,3,0,3,0,174,,,0,34,,,1,32
7/31/2016,12,60,76,148,60,113,83,256,6,172,144,322,0,9,6,15,1,3,1,5,0,160,,,0,21,,,0,28
8/1/2016,15,56,101,172,100,103,108,311,6,158,129,293,4,11,33,48,0,1,0,1,18,172,,,0,30,,,1,43
8/2/2016,14,69,69,152,83,108,99,290,4,178,121,303,1,4,7,12,0,4,0,4,0,166,,,0,25,,,0,37
8/3/2016,9,78,88,175,96,81,85,262,3,140,129,272,3,5,3,11,0,3,1,4,2,178,,,0,36,,,0,32
8/4/2016,5,64,75,144,83,94,86,263,3,167,120,290,3,5,8,16,0,1,1,2,1,184,,,0,32,,,1,33
8/5/2016,14,76,97,187,84,94,108,286,1,164,127,292,1,7,8,16,0,1,1,2,1,188,,,0,32,,,0,41
8/6/2016,21,54,100,175,52,105,77,234,5,206,129,340,3,8,3,14,0,3,0,3,0,182,,,0,23,,,0,29
8/7/2016,12,65,81,158,69,89,70,228,7,187,135,329,5,9,8,22,0,3,1,4,1,181,,,0,38,,,0,32
8/8/2016,12,80,71,163,70,106,96,272,5,146,135,286,6,6,8,20,0,8,2,10,3,163,,,1,28,,,0,34
8/9/2016,12,60,101,173,73,97,74,244,4,157,88,249,3,7,8,18,1,5,0,6,1,174,,,0,30,,,1,36
8/10/2016,15,54,85,154,76,86,83,245,3,155,100,258,1,6,12,19,0,3,0,3,0,153,,,0,26,,,0,38
8/11/2016,16,59,75,150,82,96,87,265,6,171,123,300,2,4,7,13,1,3,1,5,1,220,,,0,33,,,0,37
8/12/2016,9,71,89,169,74,100,72,246,4,127,105,236,1,5,5,11,0,1,0,1,0,162,,,0,34,,,1,27
8/13/2016,9,63,85,157,43,104,86,233,6,168,143,317,1,8,3,12,0,3,4,7,1,199,,,0,18,,,0,36
8/14/2016,8,77,75,160,58,97,71,226,6,193,147,346,3,10,5,18,1,6,2,9,0,183,,,0,24,,,0,27
8/15/2016,8,71,90,169,77,109,110,296,2,165,149,316,4,2,7,13,0,2,2,4,3,185,,,0,26,,,0,45
8/16/2016,12,66,81,159,87,108,76,271,6,160,112,278,3,6,6,15,0,5,0,5,0,170,,,0,29,,,0,35
8/17/2016,17,75,92,184,84,123,82,289,4,158,109,271,5,8,7,20,0,0,2,2,1,195,,,0,28,,,1,43
8/18/2016,9,66,105,180,89,92,74,255,7,154,121,282,1,11,9,21,0,2,0,2,1,160,,,0,39,,,1,40
8/19/2016,16,68,82,166,77,99,96,272,2,155,137,294,0,8,4,12,0,2,0,2,1,177,,,0,32,,,0,31
8/20/2016,13,67,74,154,59,117,120,296,7,175,161,343,0,7,9,16,0,2,1,3,0,172,,,0,21,,,0,37
8/21/2016,13,66,77,156,67,98,84,249,7,191,167,365,4,7,12,23,1,4,1,6,0,181,,,0,13,,,0,25
8/22/2016,18,81,82,181,91,103,101,295,7,137,122,266,0,6,14,20,0,1,0,1,0,156,,,0,27,,,0,27
8/23/2016,11,83,87,181,84,93,83,260,5,160,111,276,3,6,7,16,0,5,0,5,1,160,,,0,22,,,0,29
8/24/2016,13,88,93,194,86,104,93,283,9,149,141,299,1,9,7,17,0,3,1,4,0,197,,,0,28,,,1,30
8/25/2016,19,71,90,180,70,100,91,261,7,142,122,271,2,4,7,13,0,0,0,0,0,174,,,0,18,,,1,27
8/26/2016,23,75,112,210,74,103,99,276,4,157,124,285,2,9,12,23,0,4,0,4,1,180,,,0,23,,,1,37
8/27/2016,22,75,69,166,86,108,88,282,6,184,144,334,2,12,9,23,0,3,3,6,0,169,,,0,17,,,0,32
8/28/2016,9,68,59,136,64,100,84,248,7,205,161,373,2,9,13,24,0,4,3,7,0,168,,,0,22,,,0,30
8/29/2016,9,90,77,176,101,109,91,301,3,187,105,295,1,8,7,16,0,3,0,3,0,180,,,0,29,,,0,39
8/30/2016,17,77,98,192,100,102,86,288,3,144,102,249,5,9,6,20,0,2,1,3,2,172,,,0,24,,,0,36
8/31/2016,25,66,78,169,63,103,78,244,6,153,100,259,6,12,4,22,0,4,2,6,0,167,,,0,23,,,0,29
9/1/2016,24,75,96,195,85,113,114,312,6,163,154,323,3,16,30,49,0,1,0,1,16,196,,,0,57,,,2,53
9/2/2016,11,69,91,171,93,102,101,296,5,150,127,282,2,6,7,15,0,1,0,1,2,180,,,0,34,,,0,33
9/3/2016,15,75,67,157,60,101,89,250,10,155,134,299,3,7,11,21,0,0,2,2,0,202,,,0,36,,,1,28
9/4/2016,15,52,72,139,70,91,91,252,6,174,112,292,2,9,9,20,0,4,1,5,1,178,,,0,28,,,0,29
9/5/2016,9,68,81,158,85,92,81,258,6,188,157,351,1,7,9,17,0,9,0,9,0,191,,,0,32,,,1,29
9/6/2016,21,69,68,158,74,102,71,247,5,144,112,261,3,7,6,16,0,2,2,4,1,175,,,0,25,,,0,33
9/7/2016,12,53,86,151,66,91,71,228,5,160,78,243,3,7,5,15,0,1,2,3,0,158,,,0,28,,,0,34
9/8/2016,18,67,89,174,92,103,85,280,3,151,101,255,3,8,8,19,1,1,2,4,0,173,,,0,28,,,0,33
9/9/2016,23,77,81,181,88,95,79,262,10,167,125,302,1,11,6,18,0,0,1,1,0,179,,,0,35,,,1,32
9/10/2016,15,70,82,167,77,90,88,255,10,165,128,303,1,8,9,18,0,4,1,5,1,164,,,0,25,,,1,26
9/11/2016,19,58,71,148,55,98,74,227,11,161,135,307,3,7,7,17,0,4,0,4,0,188,,,0,19,,,0,26
9/12/2016,25,71,76,172,94,103,75,272,12,161,110,283,3,4,6,13,0,1,0,1,2,180,,,0,26,,,0,24
9/13/2016,13,83,78,174,93,94,81,268,3,180,114,297,3,6,9,18,0,0,1,1,1,170,,,0,22,,,0,35
9/14/2016,22,76,92,190,71,120,95,286,11,148,94,253,2,5,11,18,0,2,1,3,2,175,,,0,32,,,0,38
9/15/2016,20,65,99,184,96,109,100,305,8,162,96,266,0,7,8,15,0,2,1,3,1,170,,,0,19,,,0,40
9/16/2016,10,74,107,191,89,95,101,285,6,160,137,303,3,9,14,26,0,1,3,4,0,186,,,0,25,,,1,37
9/17/2016,16,64,83,163,67,102,80,249,8,192,155,355,2,7,6,15,0,0,0,0,0,200,,,0,25,,,0,31
9/18/2016,11,53,65,129,66,94,73,233,7,182,154,343,1,6,13,20,0,5,1,6,0,188,,,0,26,,,0,19
9/19/2016,15,58,84,157,107,101,76,284,5,145,146,296,3,2,10,15,0,1,0,1,0,156,,,0,19,,,0,31
9/20/2016,15,78,85,178,93,105,79,277,3,151,130,284,3,7,9,19,0,1,1,2,1,172,,,0,25,,,1,34
9/21/2016,10,56,82,148,75,90,112,277,10,153,129,292,2,6,14,22,0,4,0,4,1,165,,,0,25,,,0,40
9/22/2016,8,72,82,162,80,110,97,287,6,167,123,296,1,7,5,13,0,3,1,4,1,155,,,0,42,,,0,44
9/23/2016,14,64,88,166,71,104,100,275,8,158,126,292,8,7,3,18,0,5,1,6,2,172,,,0,50,,,0,33
9/24/2016,8,66,77,151,42,95,91,228,10,201,144,355,0,7,16,23,0,4,3,7,0,195,,,0,15,,,1,39
9/25/2016,7,57,78,142,65,106,80,251,4,189,150,343,3,8,12,23,0,2,2,4,1,173,,,0,20,,,1,29
9/26/2016,25,72,74,171,80,100,88,268,6,143,132,281,1,7,9,17,0,2,0,2,2,174,,,0,17,,,0,37
9/27/2016,16,72,80,168,77,110,81,268,7,143,121,271,2,7,9,18,0,3,1,4,1,154,,,0,33,,,1,27
9/28/2016,19,58,88,165,78,102,90,270,6,132,120,258,4,2,9,15,0,0,0,0,0,147,,,0,18,,,0,29
9/29/2016,13,54,93,160,89,84,82,255,5,145,116,266,2,1,4,7,0,1,1,2,1,160,,,0,28,,,0,36
9/30/2016,25,75,89,189,76,91,88,255,6,146,130,282,3,9,10,22,0,1,2,3,2,168,,,0,28,,,0,38
10/1/2016,12,60,96,168,96,96,94,286,9,149,142,300,3,12,26,41,0,2,1,3,22,179,,,0,18,,,2,37
10/2/2016,17,58,79,154,79,88,70,237,6,170,167,343,4,7,12,23,0,2,0,2,2,173,,,0,19,,,0,18
10/3/2016,26,68,105,199,110,94,93,297,4,156,123,283,2,11,4,17,0,2,0,2,1,168,,,0,17,,,1,32
10/4/2016,17,69,90,176,78,92,78,248,8,153,100,261,1,7,4,12,0,3,0,3,3,186,,,0,29,,,0,40
10/5/2016,29,64,83,176,83,100,84,267,7,149,121,277,3,9,3,15,0,2,2,4,0,172,,,0,42,,,0,38
10/6/2016,21,71,72,164,69,92,91,252,8,154,98,260,1,5,2,8,0,0,1,1,1,164,,,1,25,,,0,37
10/7/2016,23,71,118,212,63,104,101,268,6,163,118,287,1,7,9,17,0,2,0,2,1,214,,,0,26,,,0,42
10/8/2016,13,66,74,153,70,93,83,246,7,164,143,314,2,7,6,15,0,1,0,1,0,167,,,0,14,,,1,26
10/9/2016,14,46,77,137,61,88,60,209,4,166,154,324,2,8,10,20,0,4,1,5,0,174,,,0,11,,,0,21
10/10/2016,15,56,89,160,111,103,87,301,3,151,135,289,1,9,15,25,0,1,2,3,6,154,,,0,21,,,0,29
10/11/2016,11,57,95,163,105,92,92,289,3,139,106,248,3,8,6,17,0,2,1,3,0,169,,,0,18,,,1,27
10/12/2016,17,63,89,169,93,122,79,294,5,141,107,253,1,10,11,22,0,2,2,4,2,186,,,0,21,,,1,29
10/13/2016,20,56,91,167,81,91,83,255,10,143,114,267,2,4,1,7,0,3,0,3,1,139,,,0,32,,,0,50
10/14/2016,22,67,91,180,73,103,86,262,5,168,122,295,4,7,6,17,0,5,0,5,3,176,,,0,26,,,0,36
10/15/2016,13,78,119,210,54,93,91,238,8,176,140,324,1,6,8,15,1,3,4,8,2,176,,,0,22,,,1,38
10/16/2016,19,65,60,144,54,93,69,216,9,193,160,362,3,16,11,30,0,1,1,2,1,158,,,0,25,,,0,33
10/17/2016,19,68,85,172,81,105,80,266,5,165,123,293,3,3,6,12,0,3,1,4,1,187,,,0,26,,,0,33
10/18/2016,13,63,106,182,88,113,77,278,3,175,119,297,3,8,8,19,1,3,0,4,3,166,,,0,25,,,2,31
10/19/2016,19,70,78,167,80,98,73,251,4,152,121,277,1,5,3,9,0,2,1,3,2,182,,,0,26,,,0,23
10/20/2016,17,78,91,186,74,90,106,270,3,152,120,275,6,5,8,19,0,0,2,2,0,150,,,0,27,,,1,27
10/21/2016,19,59,102,180,70,108,83,261,4,145,108,257,3,6,8,17,0,0,1,1,3,175,,,0,34,,,0,33
10/22/2016,10,62,78,150,73,89,85,247,15,161,138,314,1,5,8,14,0,2,4,6,2,151,,,0,27,,,1,49
10/23/2016,14,62,87,163,75,91,70,236,7,182,158,347,4,7,10,21,0,6,0,6,0,182,,,0,22,,,1,30
10/24/2016,24,72,95,191,86,109,82,277,5,154,108,267,3,7,8,18,0,3,4,7,0,160,,,0,32,,,2,39
10/25/2016,18,72,82,172,91,96,95,282,3,137,117,257,4,4,6,14,0,2,2,4,3,172,,,0,25,,,0,29
10/26/2016,21,81,91,193,83,103,81,267,5,139,106,250,3,4,6,13,0,2,0,2,1,142,,,0,20,,,1,39
10/27/2016,10,61,94,165,78,108,97,283,4,137,109,250,4,6,6,16,0,2,0,2,2,151,,,0,24,,,1,29
10/28/2016,25,56,100,181,88,116,111,315,6,157,123,286,4,4,8,16,0,3,0,3,2,176,,,0,19,,,0,52
10/29/2016,20,54,79,153,52,79,112,243,11,188,115,314,3,10,5,18,0,7,4,11,1,202,,,0,20,,,0,43
10/30/2016,11,59,77,147,63,84,86,233,11,184,168,363,2,4,8,14,1,7,1,9,1,161,,,0,23,,,0,38
10/31/2016,26,91,92,209,81,85,85,251,9,164,155,328,2,7,8,17,0,4,3,7,4,193,,,0,19,,,0,36
11/1/2016,32,78,117,227,81,104,106,291,5,162,140,307,1,15,33,49,0,4,1,5,22,193,,,1,29,,,1,45
11/2/2016,21,80,83,184,87,90,84,261,6,163,116,285,0,3,5,8,1,5,0,6,5,148,,,1,15,,,0,26
11/3/2016,20,76,93,189,68,93,79,240,2,202,102,306,1,6,9,16,0,4,0,4,1,158,,,0,8,,,0,35
11/4/2016,28,69,95,192,73,93,76,242,2,152,117,271,1,6,9,16,0,3,0,3,1,164,,,0,19,,,0,40
11/5/2016,17,68,73,158,84,104,80,268,7,180,140,327,2,4,7,13,0,4,3,7,1,177,,,0,19,,,0,29
11/6/2016,23,57,79,159,71,89,75,235,7,175,143,325,2,5,6,13,1,4,1,6,1,164,,,0,23,,,0,27
11/7/2016,16,76,79,171,94,95,87,276,3,137,122,262,5,1,3,9,0,3,0,3,5,184,,,0,16,,,3,31
11/8/2016,13,67,68,148,89,85,69,243,6,142,117,265,4,5,5,14,0,2,0,2,4,147,,,0,20,,,1,28
11/9/2016,24,65,94,183,63,105,79,247,4,134,128,266,1,7,11,19,1,1,0,2,1,142,,,0,18,,,0,27
11/10/2016,20,65,96,181,86,101,85,272,3,129,137,269,1,7,10,18,0,1,0,1,4,164,,,0,25,,,1,31
11/11/2016,19,81,96,196,78,96,84,258,8,137,136,281,5,3,6,14,0,0,0,0,2,189,,,0,42,,,0,38
11/12/2016,11,69,74,154,72,85,61,218,7,162,151,320,1,5,9,15,0,3,1,4,2,176,,,0,29,,,0,27
11/13/2016,14,56,72,142,63,86,71,220,6,143,143,292,2,7,8,17,0,3,0,3,1,168,,,0,26,,,0,25
11/14/2016,25,71,84,180,93,101,90,284,8,133,113,254,3,6,8,17,0,4,1,5,2,152,,,0,22,,,0,29
11/15/2016,15,71,80,166,93,79,89,261,9,143,100,252,3,7,13,23,0,2,1,3,4,178,,,0,22,,,2,32
11/16/2016,18,74,82,174,84,93,90,267,3,147,96,246,2,5,5,12,1,3,0,4,1,164,,,0,24,,,1,36
11/17/2016,18,85,85,188,70,116,79,265,6,147,99,252,0,5,3,8,0,4,1,5,0,167,,,0,45,,,1,34
11/18/2016,17,84,100,201,76,103,83,262,4,139,117,260,1,3,8,12,0,1,0,1,3,175,,,0,39,,,1,43
11/19/2016,9,67,86,162,53,100,89,242,8,141,132,281,2,3,8,13,0,3,0,3,0,154,,,0,14,,,1,29
11/20/2016,14,60,96,170,52,75,64,191,9,145,125,279,2,4,6,12,0,5,0,5,4,158,,,0,23,,,0,23
11/21/2016,21,77,94,192,98,98,80,276,6,121,100,227,3,5,5,13,0,2,2,4,3,135,,,0,32,,,1,33
11/22/2016,20,75,80,175,77,102,75,254,4,123,113,240,3,8,12,23,0,1,0,1,1,170,,,0,33,,,0,40
11/23/2016,14,85,115,214,75,93,85,253,9,115,98,222,3,5,9,17,0,2,0,2,2,155,,,0,13,,,0,36
11/24/2016,19,58,84,161,46,53,53,152,4,148,123,275,2,6,6,14,0,0,0,0,4,127,,,0,4,,,0,16
11/25/2016,12,56,86,154,58,104,100,262,3,133,100,236,4,4,5,13,0,3,0,3,1,140,,,0,32,,,0,33
11/26/2016,18,66,99,183,76,96,83,255,6,135,114,255,0,9,7,16,0,2,0,2,3,163,,,0,35,,,0,22
11/27/2016,20,67,84,171,77,92,78,247,7,154,127,288,1,5,3,9,0,3,2,5,2,170,,,0,35,,,1,22
11/28/2016,24,76,97,197,122,106,85,313,5,125,100,230,1,2,5,8,0,2,1,3,0,147,,,0,18,,,0,30
11/29/2016,31,68,67,166,93,87,81,261,8,125,93,226,2,6,4,12,1,2,2,5,4,161,,,0,27,,,2,39
11/30/2016,23,73,79,175,91,100,86,277,2,152,100,254,2,4,13,19,0,2,0,2,1,129,,,0,31,,,0,31
12/1/2016,23,56,102,181,81,100,105,286,8,117,106,231,8,9,28,45,0,2,0,2,29,183,,,0,14,,,2,38
12/2/2016,17,83,77,177,81,102,80,263,5,148,132,285,2,5,5,12,0,3,2,5,2,182,,,0,41,,,1,35
12/3/2016,18,74,89,181,65,106,73,244,7,138,132,277,0,5,7,12,0,1,2,3,0,178,,,0,23,,,0,28
12/4/2016,22,54,83,159,58,74,79,211,5,145,117,267,1,4,7,12,0,5,1,6,2,134,,,0,18,,,2,15
12/5/2016,21,60,102,183,93,86,94,273,4,124,123,251,2,6,11,19,0,1,0,1,4,150,,,0,25,,,1,27
12/6/2016,25,81,92,198,78,106,99,283,4,128,104,236,2,3,5,10,0,2,1,3,1,152,,,0,29,,,2,30
12/7/2016,16,61,88,165,77,93,93,263,3,136,118,257,2,6,2,10,0,1,1,2,7,159,,,0,18,,,1,27
12/8/2016,17,53,94,164,86,100,100,286,3,108,112,223,0,7,3,10,0,1,0,1,6,131,,,0,23,,,0,29
12/9/2016,16,64,96,176,76,83,93,252,1,120,123,244,2,8,11,21,0,3,1,4,3,154,,,0,28,,,0,37
12/10/2016,15,52,102,169,76,84,78,238,2,121,146,269,4,5,9,18,1,0,3,4,1,163,,,0,31,,,1,29
12/11/2016,10,50,78,138,53,72,79,204,3,125,145,273,0,3,6,9,0,1,0,1,4,117,,,0,20,,,0,22
12/12/2016,27,78,87,192,99,83,98,280,4,106,130,240,3,5,10,18,1,3,0,4,8,142,,,0,29,,,0,33
12/13/2016,19,54,91,164,94,85,85,264,8,108,128,244,2,1,8,11,0,0,1,1,3,144,,,0,23,,,0,31
12/14/2016,29,69,100,198,110,102,90,302,5,110,113,228,2,5,6,13,0,0,1,1,6,118,,,0,27,,,0,36
12/15/2016,25,46,146,217,85,86,94,265,6,105,108,219,1,2,6,9,0,1,1,2,8,136,,,0,18,,,2,40
12/16/2016,21,64,118,203,96,87,103,286,8,130,111,249,2,9,10,21,0,6,1,7,7,146,,,0,25,,,1,35
12/17/2016,25,56,98,179,56,106,79,241,8,117,112,237,3,0,11,14,0,2,1,3,3,123,,,0,22,,,1,41
12/18/2016,17,47,96,160,64,67,76,207,7,149,140,296,1,2,12,15,1,1,0,2,4,119,,,0,23,,,0,25
12/19/2016,20,67,94,181,84,82,98,264,5,136,112,253,3,6,3,12,1,1,1,3,9,159,,,0,17,,,1,34
12/20/2016,18,70,112,200,79,99,96,274,8,118,120,246,1,2,9,12,0,0,0,0,12,173,,,0,20,,,0,31
12/21/2016,20,81,89,190,73,101,88,262,4,127,99,230,4,3,7,14,0,0,0,0,7,155,,,0,32,,,2,48
12/22/2016,18,88,113,219,98,92,105,295,5,140,101,246,2,5,3,10,0,1,0,1,9,141,,,0,24,,,0,34
12/23/2016,22,67,152,241,86,104,100,290,7,128,109,244,1,3,7,11,0,2,0,2,1,166,,,1,26,,,2,38
12/24/2016,18,63,128,209,56,90,68,214,7,135,110,252,0,4,7,11,0,3,0,3,8,146,,,1,6,,,0,25
12/25/2016,18,54,82,154,64,55,32,151,6,140,123,269,2,5,9,16,0,7,0,7,8,121,,,0,5,,,1,13
12/26/2016,25,63,74,162,67,90,67,224,7,156,111,274,3,3,7,13,0,1,1,2,4,146,,,1,11,,,1,28
12/27/2016,29,79,87,195,89,92,74,255,6,129,101,236,1,0,4,5,0,2,0,2,10,130,,,0,28,,,1,46
12/28/2016,34,87,90,211,99,98,82,279,7,118,95,220,1,0,5,6,0,1,2,3,9,184,,,0,19,,,2,41
12/29/2016,27,57,81,165,102,87,107,296,5,125,101,231,3,6,5,14,1,1,0,2,4,171,,,0,29,,,1,39
12/30/2016,26,81,84,191,100,102,85,287,9,133,116,258,0,6,6,12,0,2,0,2,23,187,,,1,27,,,1,43
12/31/2016,26,70,86,182,73,93,83,249,11,147,116,274,6,8,13,27,0,2,0,2,21,166,,,3,14,,,0,23
12/31/2299,6314,22187,31575,60076,28666,33840,31202,93708,2239,55952,45777,103968,809,2326,3012,6147,38,764,293,1095,625,60767,,,17,12714,,,100,11874
